7 5 3
3 3
4 3
5 3
2 1 SE

$$$$$$$$$$$ 0
$#########$	1
$#########$	2
$#########$	3
$#########$	4	
$#########$	5
$#########$	6
$$$$$$$$$$$	7

6 1 -> 7 2

n+1-x+y